############
#A#     #  #
# # ### # ##
# # # #    #
# # # ### ##
#     # #  #
####### # ##
#       #  #
# ####### ##
#     B    #
############
