##########
#A       #
##### ####
#     #  #
# ##### ##
#   #    #
### ######
#        #
## #######
#B       #
##########
