# ####### # #
#         # #
### ##### # #
#   #   # # #
# # ### # # #
# #   B # # #
# ### ### # #
#     # A   #
#############
